R 1900 1400
NO ./textures/Stone2L.XPM
SO ./textures/colorstone.XPM
WE ./textures/purplestone.XPM
EA ./textures/redbrick.XPM
S ./textures/barrel.xpm
F 220,100,0
C 225,30,0
FL ./textures/mur.xpm
S1 ./textures/pillar.xpm
S2 ./textures/greenlight.xpm
11111111111111111111111111111
10000000001100000000000000001
10110000011100000230000010001
10010000000000000230000012341
10110000011100000000000000001
10000000001100000111011110N01
11110111111111011100000010001
11110111111111011101010010001
11000000110101011100000010001
10002000000000001100000010001
10000000000000001101010010001
11000000110101011111011110001
11110111111101011111011110001
11111111111111111111111111111
